!Microsoft IME Dictionary Tool
!Version: 1.1.0

![怪レい日本语辞畫]
!贵樣はこゐ辞畫を使て正レい日本语を使ラことが出來ゑ。
!これば英オ教育てあゑ。

あやしい	怪レい日本语	名詞	怪レい
あや	怪レい	名詞	怪レい
あやし	怪レい	名詞	怪レい
あやしい	怪レい	名詞	怪レい
にほんご	日本语	名詞	怪レい
ただしい	正レい	名詞	怪レい
ただしい	正規	名詞	怪レい
きさま	贵樣	名詞	怪レい
あなた	贵樣	名詞	怪レい
たいへん	大變	名詞	怪レい
それ	そね	名詞	怪しい
とても	極度	名詞	怪レい
めっちゃ	極度	名詞	怪レい
ちゅうごく	中國	名詞	怪レい
ちゅうごく	中华	名詞	怪レい
ちゅうごく	中华民国	名詞	怪レい
にほん	日本國	名詞	怪レい
にっぽん	日本國	名詞	怪レい
ゆうしゅう	优秀	名詞	怪レい
ゆうしゅう	优秀の人材	名詞	怪レい
いそが	多忙	名詞	怪レい
ちゅう	中华制	名詞	怪レい
ふえる	增えゐ	名詞	怪レい
まいくら	我的世界	名詞	怪レい
まいんく	我的世界	名詞	怪レい
めし	食事	名詞	怪レい
ごはん	食事	名詞	怪レい
よむ	解读	名詞	怪レい
よめない	解读不可	名詞	怪レい
べんきょう	勉强	名詞	怪レい
ねだん	金额	名詞	怪レい
きんがく	金额	名詞	怪レい
かう	购入	名詞	怪レい
まけ	负げ	名詞	怪レい
しゅと	香港	名詞	怪レい
こうにゅ	购入	名詞	怪レい
ひろい	雄大	名詞	怪レい
おすすめ	推奨	名詞	怪レい
むず	困难	名詞	怪レい
きけん	危險	名詞	怪レい
かいわ	會話	名詞	怪レい
あぶない	危險	名詞	怪レい
じかん	时间	名詞	怪レい
けっか	结果	名詞	怪レい
すぽー	ヌポ一ッ	名詞	怪レい
きょうりょく	团结	名詞	怪レい
だんけつ	团结	名詞	怪レい
よい	有効	名詞	怪レい
けいさつ	武装警察	名詞	怪レい
かく	描画	名詞	怪レい
えがく	描画	名詞	怪レい
たぴ	夕匕オ力	名詞	怪レい
すぐれ	优れている	名詞	怪レい
じしょ	辞畫	名詞	怪レい
かんたん	简単	名詞	怪レい
ぜっさん	绝赞	名詞	怪レい
たつじん	达人	名詞	怪レい
ねっちゅう	热中症	名詞	怪レい
しんらい	信赖	名詞	怪レい
たて	防暴盾	名詞	怪レい
みんな	人民	名詞	怪レい
みんな	全员	名詞	怪レい
すまほ	HUAWEI	名詞	怪レい
さぎょう	作业员	名詞	怪レい
ぜんいん	全员	名詞	怪レい
でんわ	电话	名詞	怪レい
ひほう	悲报	名詞	怪レい
ぼうけん	冒险	名詞	怪レい
きれい	绮丽	名詞	怪レい
かくせい	觉せソ剂	名詞	怪レい
よろ	宜レㄑ(敵意)	名詞	怪レい
とうふ	ピータソ豆腐	名詞	怪レい
かいはつ	开発	名詞	怪レい
ふぉろ	フォー	名詞	怪レい
ひつよう	必买	名詞	怪レい
ひっす	必买	名詞	怪レい
ねるねるねるね	ねゑねゑねゑね	名詞	怪レい
がくせい	學生	名詞	怪レい
はたら	極度勞動	名詞	怪レい
それん	ソビ卫ト連邦(敵意)	名詞	怪レい
それん	ン匕工ㇳ社会主儀共和國連邞	名詞	怪レい
そびえと	ソビ卫ト連邦(敵意)	名詞	怪レい
そびえと	ン匕工ㇳ社会主儀共和國連邞	名詞	怪レい
とうし	投资	名詞	怪レい
みち	轨道上	名詞	怪レい
ちゅうごくきょ	中国共产党员	名詞	怪レい
めず	異端	名詞	怪レい
がちゃ	ガタガタ	名詞	怪レい(ガチャガチャのこと)
ぴーらー	ピラー	名詞	怪レい
しゅうせいずみ	修正济	名詞	怪レい
せんのうずみ	洗脳济	名詞	怪レい
おとこ	绅士	名詞	怪レい
しんし	绅士	名詞	怪レい
ねんれい	年龄	名詞	怪レい
たばこ	烟草	名詞	怪レい
がくれき	学历	名詞	怪レい
しょくぎょう	职业	名詞	怪レい
まいにち	每日	名詞	怪レい
ひんしつ	品质	名詞	怪レい
とりあつかい	取及	名詞	怪レい
かくしん	确信	名詞	怪レい
ざっか	杂货	名詞	怪レい
たぴおか	夕匕オ力	名詞	怪レい
ていき	定棋	名詞	怪レい
こんびに	⊐ソ匕゛㆓	名詞	怪レい
ぞんび	廃人(ン゛ソヒ)	名詞	怪レい
びょういん	鄭州大學第一附属㾍唍	名詞	怪レい
びょういん	㾍唍	名詞	怪レい
さんどいっち	サソㇳ゛亻千	名詞	怪レい
がんばん	岩鎜	名詞	怪レい
しょうひん	啇品	名詞	怪レい
しょうばい	啇壳	名詞	怪レい
れんぽう	連邞	名詞	怪レい
うーぱー	墨西哥山椒魚	名詞	怪レい(ウーパールーパー)
かくりつ	确䔞	名詞	怪レい
しゅっきん	每日任务	名詞	怪レい
むりょう	无料	名詞	怪レい

く	ㄑ	名詞	怪レい
くに	國	名詞	怪レい
えん	元	名詞	怪レい
くろ	黑	名詞	怪レい
わたし	仆	名詞	怪レい
おわり	终	名詞	怪レい
くる	來	名詞	怪レい
ちが	违	名詞	怪レい(違)
かみ	神	名詞	怪レい
かお	颜	名詞	怪レい
かち	胜	名詞	怪レい(勝)
あいだ	间	名詞	怪レい
とも	发	名詞	怪レい
なが	长	名詞	怪レい
とぶ	飞	名詞	怪レい
むすぶ	结	名詞	怪レい
はな	话	名詞	怪レい
よう	樣	名詞	怪レい
ばしょ	场	名詞	怪レい(場)
だれ	谁	名詞	怪レい
せつ	说	名詞	怪レい(説)
あらわ	现	名詞	怪レい
めし	饭	名詞	怪レい
さかな	鱼	名詞	怪レい
とり	鸡	名詞	怪レい
きゅう	级	名詞	怪レい
さん	參	名詞	怪レい
つぶす	溃	名詞	怪レい
やかた	馆	名詞	怪レい
てつ	铁	名詞	怪レい
ぎん	银	名詞	怪レい
にせ	伪	名詞	怪レい
おび	带	名詞	怪レい
みる	见	名詞	怪レい
のむ	饮	名詞	怪レい(飲)
まい	每	名詞	怪レい
さま	樣	名詞	怪レい
る	儿	名詞	怪レい
たしかめ	确	名詞	怪レい
ざつ	杂	名詞	怪レい(雑)
わるい	恶	名詞	怪レい
やまい	㾍	名詞	怪レい
い	亻	名詞	怪レい
ら	꘥	名詞	怪レい
こ	⊐	名詞	怪レい
ん	ソ	名詞	怪レい
ひ	匕	名詞	怪レい
うる	壳	名詞	怪レい(売)
る	ゑ	名詞	怪レい
す	ㄡ	名詞	怪レい
はいる	𐒳	名詞	怪レい
と	ㇳ	名詞	怪レい
ち	千	名詞	怪レい
の	ゐ	名詞	怪レい
は	⼋	名詞	怪レい
せ	ㄝ	名詞	怪レい
さ	ㄜ	名詞	怪レい
せ	乜	名詞	怪レい
のる	乘	名詞	怪レい
て	Ꞇ	名詞	怪レい
しゃ	社	名詞	怪レい
しょう	啇	名詞	怪レい
うつ	鬰	名詞	怪レい
れん	連	名詞	怪レい
うむ	產	名詞	怪レい
にし	酉	名詞	怪レい
うた	哥	名詞	怪レい

０	零	名詞	怪レい
１	壱	名詞	怪レい
２	贰	名詞	怪レい
３	叁	名詞	怪レい
４	䦉	名詞	怪レい
５	伍	名詞	怪レい
６	陸	名詞	怪レい
７	柒	名詞	怪レい
８	捌	名詞	怪レい
９	玖	名詞	怪レい
１０	什	名詞	怪レい
じゅう	什	名詞	怪レい
１００	佰	名詞	怪レい
ひゃく	佰	名詞	怪レい
１０００	仟	名詞	怪レい
せん	仟	名詞	怪レい

しなさい	（しなさい）	名詞	怪レい
きゅうりょ	給料を20000000元(払いなさい)	名詞	怪レい
きゅうりょう	給料を20000000元(払いなさい)	名詞	怪レい
きょくど	極度乾燥（しなさい）	名詞	怪レい
おいしい	美味てあゑ	名詞	怪レい
うまい	美味てあゑ	名詞	怪レい
だめ	(いけません)	名詞	怪レい
した	レた	名詞	怪レい
です	ごす	名詞	怪レい

やだ	ばい	感動詞	怪レい
やだ	ばぃ	感動詞	怪レい
いや	ばい	感動詞	怪レい
いや	ばぃ	感動詞	怪レい
おｋ	ばい(了承)	感動詞	怪レい
おｋ	ばぃ(了承)	感動詞	怪レい
いい	ばい(了承)	感動詞	怪レい
いい	ばぃ(了承)	感動詞	怪レい
いいね	良い	感動詞	怪レい
いいね	良ぃ	感動詞	怪レい
すご	ずこいれ	感動詞	怪レい
すごい	ずこいれ	感動詞	怪レい
すごい	すごいれ	感動詞	怪レい
よかったね	よがったれ	感動詞	怪レい
ｗ	23333	感動詞	怪レい(草を生やす)
くさ	23333	感動詞	怪レい(草を生やす)
わら	23333	感動詞	怪しい(草を生やす)
うまい	ラまい！！	感動詞	怪レい


!MIT License

!Copyright 2021 Rinrin.py

!Permission is hereby granted, free of charge, to any person obtaining a copy of this software and associated documentation files (the "Software"), to deal in the Software without restriction, including without limitation the rights to use, copy, modify, merge, publish, distribute, sublicense, and or sell copies of the Software, and to permit persons to whom the Software is furnished to do so, subject to the following conditions:

!The above copyright notice and this permission notice shall be included in all copies or substantial portions of the Software.

!THE SOFTWARE IS PROVIDED "AS IS", WITHOUT WARRANTY OF ANY KIND, EXPRESS OR IMPLIED, INCLUDING BUT NOT LIMITED TO THE WARRANTIES OF MERCHANTABILITY, FITNESS FOR A PARTICULAR PURPOSE AND NONINFRINGEMENT. IN NO EVENT SHALL THE AUTHORS OR COPYRIGHT HOLDERS BE LIABLE FOR ANY CLAIM, DAMAGES OR OTHER LIABILITY, WHETHER IN AN ACTION OF CONTRACT, TORT OR OTHERWISE, ARISING FROM, OUT OF OR IN CONNECTION WITH THE SOFTWARE OR THE USE OR OTHER DEALINGS IN THE SOFTWARE.
